%%%%%%%%%%%%%%%%%%%%
%F           FF    %
%F  F  F  F  FF    %
%                  %
%                  %
%                  %
%                  %
%        S         %
%%%%%%%%%%%%%%%%%%%%