%%%%%%%%%%%%%%%%%%%%%%%%%
%F                 E E  %
%                       %
%                       %
%                       %
%                       %
%                       %
%                       %
%                   S   %
%%%%%%%%%%%%%%%%%%%%%%%%%