%%%%%%%%%%%%%%%%%%%%%%%
%F                    %
%                     %
%                     %
%                     %
%                     %
%                     %
%                     %
%                     %
%                 S   %
%                     %
%%%%%%%%%%%%%%%%%%%%%%%