%%%%%%%%%%%%%%%%%%%%%%%%%
%F                      %
%                       %
%                       %
%                       %
%                       %
%                       %
%                       %
%                       %
%                       %
%                       %
%                       %
%                       %
%                       %
%                       %
%             S         %
%                       %
%                       %
%%%%%%%%%%%%%%%%%%%%%%%%%