%%%%%%%%%%%%%%%%%%%%%%%%%
%F                     F%
%F                 F    %
%                       %
%                       %
%                       %
%                       %
%                       %
%                       %
%                       %
%                       %
%                       %
%                       %
%                       %
%                       %
%             S         %
%                       %
%                       %
%%%%%%%%%%%%%%%%%%%%%%%%%