%%%%%%%%%%%%%%%%%%%%%
%F                  %
%                   %
%                   %
%                   %
%                  S%
%%%%%%%%%%%%%%%%%%%%%