%%%%%%%%%%%%%%%%%%%%%%%%%
%         E             %
%                 E     %
% F  F          F  F    %
%                       %
%                       %
%                       %
%                       %
%                       %
%                       %
%                       %
%                       %
%                       %
%                       %
%                       %
%     S                 %
%                       %
%                       %
%%%%%%%%%%%%%%%%%%%%%%%%%