%%%%%%%%%%%%%%%%
%F         E FF%
%F  F  F  F  FF%
%              %
%              %
%              %
%              %
%        S     %
%%%%%%%%%%%%%%%%