%%%%%%%%%%%%%%%%%%%%%%%%%
%F                     F%
%                       %
%                       %
%                       %
%                       %
%                       %
%                       %
%                       %
%                       %
%                       %
%                       %
%                       %
%                       %
%                       %
%       S               %
%                       %
%                       %
%%%%%%%%%%%%%%%%%%%%%%%%%