%%%%%%%%%%%%%%%%%%%%%%%%%
%F                      %
%                       %
%                       %
%                       %
%                       %
%                       %
%                       %
%                      S%
%%%%%%%%%%%%%%%%%%%%%%%%%