%%%%%%%%%%%%%%%%
%F    E    E FF%
%F  F  F  F  FF%
%              %
%              %
%              %
%              %
%        S     %
%%%%%%%%%%%%%%%%