%%%%%%%%%%%%%%%%%%%%%%%%%
%                      F%
%                       %
%                       %
%                       %
%                       %
%                       %
%                       %
%                       %
%                       %
%                       %
%                       %
%                       %
%                       %
%                       %
%S                      %
%                       %
%                       %
%%%%%%%%%%%%%%%%%%%%%%%%%