%%%%%%%%
%F   E %
%      %
%      %
%     S%
%%%%%%%%