%%%%%%%%%%%%%%%%%%%%%%%%%
% F                   F %
%              E        %
%     F                 %
%                   F   %
%                       %
%                       %
%                F      %
%                       %
%             F         %
%                       %
%                       %
%           S           %
%                       %
%                       %
%%%%%%%%%%%%%%%%%%%%%%%%%