%%%%%%%%
%F   E %
% E    %
%      %
%     S%
%%%%%%%%